1X111111111111111111111
10000000000000000000001
11111010101111101011111
10001010100010001010001
11101110111010111110101
10001000100010000000101
10111010111110111111101
10000010100010000000101
11111111101010111110101
10000000101010000010101
10111110111011111010101
10000010000010000010101
11111010101111111110101
10001010100010000000101
10101010111110111111101
10100010001000100010001
10101011101011111010101
10101000101000000010101
10101111101111111110101
10101000100010000000101
10111010111110111111101
10000010000000100000001
111111111111111111111N1