11111111111111111111111
10000000000000000100001
10111111111111111110101
10100000000000000010101
10101111111111111010101
10101111111S11111010101
10101000000000000010101
10101111111111111110101
10100000000000000000101
101111111111111111111X1
10000000000000000000001
11111111111111111111111
