11111111111111111111111111111
10000000000000000000000000001
10111111111111111111111111101
10100000000000000000000000101
10101111111111111111111110101
10101000000000000000000010101
10101011111111111111111010101
10101111111111111111111010101
10100000000000000000000010101
10111111111111111111111110101
10000000000000000000000000101
11111111111111111111111110101
10000000000000000000000010101
10111111111111111111111010101
10100000000000000000001010101
10101111111111111111101010101
10101X11111111111111101010101
10101000000000000000001010101
10101111111111111111111010101
10100000000000000000000010101
10111111111111111111111110101
10000000000000000000000000101
111111111111111111111111111N1