1X1111111111111111111111111111111
100000000000000000001000100000101
111010111011111111101010101010101
100010001010000000100010101010001
101011101110111110101110101111111
101000100010100010100010100000001
101110111010101010101010101111101
100010001010101010101010101000001
101011101011101010101010111011111
101000101000101000101010000010001
101111101110101011101011111111101
101000101010001010101000000000101
101010101011101010101111111110101
101010001000101000100000000010001
101011111110111111111011111010111
101000000010100000001000001010001
101111111010101111101111101011101
101000001000101000001000001010001
101011101111101011111010111011111
101010001000001010001010100010001
101010111011111010101010101110101
100010000010000010100010100000101
1N1111111111111111111111111111111
